             
 C . . .   M 
 - - - - - - 
 . . . . . . 
             
 . . H . . . 
             
 . . . . . . 
 - - = - - - 
 . . C . . . 
             
 . . . . . . 
           S 